{
    "MaxRow":9,
    "MaxCol":9,
    "Cells":[
                0,0,1,1,1,1,1,0,0,
                0,1,1,1,1,1,1,1,0,
                1,1,1,1,1,1,1,1,1,
                1,1,1,0,0,0,1,1,1,
                1,1,1,0,0,0,1,1,1,
                1,1,1,0,0,0,1,1,1,
                1,1,1,1,1,1,1,1,1,
                1,1,1,1,1,1,1,1,1,
                1,1,1,1,1,1,1,1,1
             ]
}